9.ox
..o......
.o.......
.o...p...
.........
.o...oo..
o..o.....
........o
.......o.
.......o.
